  1111111111111111111111111        1000000000110000000000001        1011000001110000000000001        1001000000000000000000001111111111011000001110000000000001100000000011000001110111111111111111101111111110111000000100011111011111111101110101001000111000000110101011100000010001100000000000000011000000100011000000000000000110101001000111000001110101011111011110N011111110111 1110101 10111101000111111111 1111111 111111111111