        1111111111111111111111111\n        1000000000110000000000001\n        1011000001110000000000001\n        1001000000000000000000001\n111111111011000001110000000000001\n100000000011000001110111111111111\n11110111111111011100000010001\n11110111111111011101010010001\n11000000110101011100000010001\n10000000000000001100000010001\n10000000000000001101010010001\n11000001110101011111011110N0111\n11110111 1110101 101111010001\n1111111111111111 111111111111\n